...###.....
..##.#.####
.##.......#
###.......#
#.#....#..#
###..###..#
..#..#....#
.#####.#.##
.##.....##
.#..@..##
.#######